# Special countries
REB = "countries/rebels.txt"

# North America - Canada

BCB = "countries/British Columbia.txt"
CPR = "countries/Canadian Prairies.txt"
MAR = "countries/Canadian Maritimes.txt"
NFL = "countries/Newfoundland.txt"
NWT = "countries/Northwest Territories.txt"
ONT = "countries/Ontario.txt"
QBC = "countries/Quebec.txt"

# North America - Western United States

ASK = "countries/Alaska.txt"
ASW = "countries/American Southwest.txt"
CAL = "countries/California.txt"
GPL = "countries/Great Plains.txt"
HAW = "countries/Hawaii.txt"
IMT = "countries/Intermountain.txt"
NAV = "countries/Navajo.txt"
OZK = "countries/Ozark.txt"
PNW = "countries/Pacific Northwest.txt"
TEX = "countries/Texas.txt"

# North America - Eastern United States

CAR = "countries/Carolina.txt"
DIX = "countries/Dixie.txt"
FLA = "countries/Florida.txt"
ILL = "countries/Illinois.txt"
MAT = "countries/Mid Atlantic.txt"
NAP = "countries/North Appalachia.txt"
NEN = "countries/New England.txt"
NOL = "countries/New Orleans.txt"
NYC = "countries/New York.txt"
SAP = "countries/South Appalachia.txt"
UGL = "countries/Union of Great Lakes.txt"
UMW = "countries/Upper Midwest.txt"
#NYS = "countries/New York State.txt"

# North America - Civil War Factions

NCA = "countries/North California.txt"
NTX = "countries/North Texas.txt"
SCA = "countries/South California.txt"
STX = "countries/South Texas.txt"

# North America - Canadian Unification

WCA = "countries/West Canada.txt"
ECA = "countries/East Canada.txt"
CAN = "countries/Canada.txt"

# North America - US Unification

# UNW = "countries/Northwestern United States.txt"
# USW = "countries/Southwestern United States.txt"
# UNC = "countries/Northcentral United States.txt"
# USC = "countries/Southcentral United States.txt"
# UNE = "countries/Northeastern United States.txt"
# USE = "countries/Southeastern United States.txt"
USA = "countries/United States of America.txt"

# Latin and South America - Mexico

SON = "countries/Sonora.txt"
CHH = "countries/Chihuahua.txt"
RGR = "countries/Rio Grande.txt"
BAJ = "countries/Bajio.txt"
CDM = "countries/Mexico City.txt" #Similar flavour to capital USA
WMX = "countries/West Mexico.txt"
EMX = "countries/East Mexico.txt"
CHP = "countries/Chiapas.txt" #Should add Zapatista flavour
YUC = "countries/Yucatan.txt"

# Latin and South America - Central America

GUA = "countries/Guatemala.txt"
#BLZ = "countries/Belize.txt" #Note. should be able to discover oil here
ELS = "countries/El Salvador.txt"
HON = "countries/Honduras.txt"
NIC = "countries/Nicaragua.txt"
COS = "countries/Costa Rica.txt"
PNM = "countries/Panama.txt"
PCZ = "countries/Panama Canal Zone.txt"

# Latin and South America - Caribbean

BHS = "countries/Bahamas.txt"
#BRM = "countries/Bermuda.txt"
CUB = "countries/Cuba.txt"
HAI = "countries/Haiti.txt" #
DOM = "countries/Dominican Republic.txt"
ANT = "countries/Antilles Federation.txt"
JAM = "countries/Jamaica.txt"
PEU = "countries/Puero Rico.txt"
TRT = "countries/Trinidad and Tobago.txt"
#... add all the small islands


# Latin and South America - Andes

#Colombia fragments
CLM	="countries/Colombia.txt"
FRC ="countries/FARC.txt"
#Venezuela fragments
VEN	="countries/Venezuela.txt"
TRO	="countries/Transorinoco.txt"
ECU = "countries/Ecuador.txt"
#Peru fragments
PRU	="countries/Peru.txt"
PRS = "countries/Shining Path.txt"
#Bolivia fragments
BOL = "countries/Bolivia.txt"

#guianas
GUY = "countries/Guyana.txt"
SUR = "countries/Suriname.txt"
FGU = "countries/French Guiana.txt"

# North Latin America - Unification
#Norteno tag for North Mexico
#"Sorteno" tag, South Mexico
MEX = "countries/Mexico.txt"
#UCA = "countries/Central America.txt"
#CBB = "countries/Caribbean.txt"
#NSP = "countries/New Spain.txt" #For Mexico+Cent.Am+Caribbean tag, loc key will be different
#GCO = "countries/Gran Colombia.txt"
#PBC = "countries/Peru-Bolivia.txt"
#ANN = "countries/Andinea.txt" #Andes formable, can annex Chile by invasion decision (no cores)

# Latin and South America - Southern Cone

#Argentina fragments
PAR = "countries/Paraguay.txt"
URU = "countries/Uruguay.txt"
BUE = "countries/Buenos Aires.txt"
MDA = "countries/Mendosa.txt"
ERP = "countries/ERP.txt"
STF = "countries/Santa Fe.txt"
ETR = "countries/Entre Rios.txt"
SLT = "countries/Salta.txt"
#Chile fragments #not generic Patagonia vs north split plz
SCL = "countries/South Chile.txt"
NCL = "countries/North Chile.txt"

# Latin and South America - Brazil
#So many fragments
MNU = "countries/Manaus.txt"
RGS = "countries/Rio Grande so Sul.txt"
SPL = "countries/Sao Paulo.txt"
MGE = "countries/Minas Gerais.txt"
RIO = "countries/Rio de Janeiro.txt"
BPR = "countries/Para Federation.txt"
MGS = "countries/Mato Grosso.txt"
BAI = "countries/Bahia.txt"
BNU = "countries/Nordeste Union.txt"

# Latin and South America - Southern Formables
BRA = "countries/Brazil.txt"
#SBZ = "countries/South Brazil.txt"
#NBZ = "countries/North Brazil.txt"
#PLN = "countries/Platinea.txt" #formable for North Argentina
PAT = "countries/Patagonia.txt" 
#LPL = "countries/La Plata.txt"
#GRR = "countries/Guaraninea.txt" #Paraguy, Bolivia, Mata Grosso formable
#CHL = "countries/Chile.txt"
ARG = "countries/Argentina.txt"

# Europe - GIUK #Original Victopia setup: GRN, ICE, IRE, ENG, SCO, WAL, NIR. Choose more fragmentation for Scramble for Europe scenario.

GRN = "countries/Greenland.txt"
ICE = "countries/Iceland.txt" #Race to form Denmark
WLS = "countries/Wales.txt"
NIR = "countries/Northern Ireland.txt"
#NRR = "countries/Norrmark.txt"
#COK = "countries/Cork.txt"
#DUB = "countries/Dublin.txt"
EDB = "countries/Edinburgh.txt"
#IVN = "countries/Inverness.txt"
GBN = "countries/British Navy.txt" #remnants of GB, will turn into inverness if unsuccessful
GLS = "countries/Glasgow.txt" #3-way division of scotland
#LVP = "countries/Liverpool.txt"
#MDL = "countries/Midlands.txt"
#YOR = "countries/York.txt"
GUE = "countries/Guernsey.txt"

#GIUK Formables
EGL = "countries/England.txt"
NNG = "countries/North England.txt"
GBR = "countries/United Kingdom.txt"
IRE = "countries/Ireland.txt"
SCO = "countries/Scotland.txt"

FRR = "countries/French Reminant.txt"
CRS = "countries/Corsica.txt"

#Europe, Colony flavour
#LON = "countries/London.txt"
#CNN = "countries/Cornwall.txt" #Should appear by event and try to unify with Wales ~20 yrs before scramble
#NMN = "countries/Normandy.txt"
FRA = "countries/France.txt"
#BRT = "countries/Brittany.txt"
SPA = "countries/Spain.txt"
#POR = "countries/Portugal.txt"
AZO = "countries/Azores.txt"
MDI = "countries/Maeira.txt"
#ADL = "countries/Andalusia.txt"
ITA = "countries/Italy.txt"
#SIC = "countries/Sicily.txt"
NET = "countries/Netherlands.txt"
#DEN = "countries/Denmark.txt"
#NOR = "countries/Norway.txt"
#SWE = "countries/Sweden.txt"
#GER = "countries/Germany.txt"
#SER = "countries/Serbia.txt"
#CRO = "countries/Croatia.txt"
#BOS = "countries/Bosnia.txt"
#ALB = "countries/Albania.txt"
NRM = "countries/Normark.txt"
LUX = "countries/Luxembourg.txt"
MLT = "countries/Malta.txt"

#East Europe
FIN = "countries/Finland.txt"
EST = "countries/Estonia.txt"
LAT = "countries/Latvia.txt"
LTH = "countries/Lithuania.txt"
WRA = "countries/Western Red Army.txt"
BYE = "countries/Byelorussia.txt"
BLR = "countries/Belarus.txt"

WUK = "countries/West Ukraine.txt"
EUK = "countries/East Ukraine.txt"
ODE = "countries/Odesa.txt"
UKR = "countries/Ukraine.txt"
CRI = "countries/Crimea.txt"

NCK = "countries/North Caucasus Krai.txt"
KMY = "countries/Kalmykia.txt"
AKH = "countries/Astrakhan.txt"
KOM = "countries/Komi.txt"
MDV = "countries/Mordovia.txt"
CHV = "countries/Chuvashia.txt"
MRI = "countries/Mari.txt"
UDM = "countries/Udmurt.txt"
PRM = "countries/Perm.txt"
TAT = "countries/Tatarstan.txt"

MSK = "countries/Muscovy.txt"
NOV = "countries/Novgorod.txt"
VOL = "countries/Volgograd.txt"
ARK = "countries/Arkhangelsk.txt"
MUR = "countries/Murmansk.txt"
PSK = "countries/Pskov.txt"
KAR = "countries/Karelia.txt"
IDU = "countries/Idel-Ural.txt"
RUS = "countries/Russia.txt"
SOV = "countries/Soviet Union.txt"

#Central Asia
KAZ = "countries/Kazakhstan.txt"
UZB = "countries/Uzbekistan.txt"
TRK = "countries/Turkmenistan.txt"
KYR = "countries/Kyrgystan.txt"
KAP = "countries/Karakalpakstan.txt"
TJI = "countries/Tajikistan.txt"
ETK = "countries/East Turkestan.txt"
TIB = "countries/Tibet.txt"

#East Asia
ALT = "countries/Altai.txt"
TUV = "countries/Tuva.txt"
SIB = "countries/Siberian Republic.txt"
YAM = "countries/Yamalia.txt"
YUG = "countries/Yugra.txt"
SAK = "countries/Sakha.txt"
FER = "countries/Far Eastern Republic.txt"
BRY = "countries/Buryatia.txt"

MNG = "countries/Mongolia.txt"
IMG = "countries/Inner Mongolia.txt"
MCH = "countries/Manchuria.txt"
BEJ = "countries/Beijing.txt"
SHA = "countries/Shaanxi.txt"
QGH = "countries/Qinghai.txt"
SCU = "countries/Sichuan.txt"
YUN = "countries/Yunnan.txt"
HUB = "countries/Hubei.txt"
HNN = "countries/Hunan.txt"
GUZ = "countries/Guizhou.txt"
GUX = "countries/Guangxi.txt"
JGX = "countries/Jiangxi.txt"
NAN = "countries/Nanjing.txt"
TAI = "countries/Taiwan.txt"
HNK = "countries/Hong Kong.txt"
MCA = "countries/Macao.txt"
PRD = "countries/Pearl River Republic.txt"
SHG = "countries/Shanghai.txt"
ROC = "countries/Republic of China.txt"
CHI = "countries/China.txt"

NKR = "countries/North Korea.txt"
SKR = "countries/South Korea.txt"
KOR = "countries/Korea.txt"

JAP = "countries/Japan.txt"
USJ = "countries/Kyushu Governate.txt"
CFR = "countries/Council Federation Republics.txt"
KYT = "countries/Kyoto.txt"
TKY = "countries/Tokyo.txt"


#West Africa
MOR = "countries/Morocco.txt"
ALG = "countries/Algeria.txt"
EPN = "countries/Pied Noir.txt"
TUS = "countries/Tunisia.txt"
LYB = "countries/Libya.txt"
CBV = "countries/Cabo Verde.txt"

##Countries of the OAU
#OAS unified tags
WAU = "countries/West Africa.txt" #
NSR = "countries/New Songhai Republic.txt"#
OAS = "countries/Organization of African States.txt" #Organization of African Unity, Monrovia-Casablanca Group. Ghana, Guinea, Mali. Social Democratic dictatorship, but vassals are limited democracies, govtype African Union Member
MLF = "countries/Mali Federation.txt"#What the OAS evolved from, and what it will devolve into after 1st breakdown
#MAL = "countries/Mali.txt"
SOU = "countries/Sudanese Republic.txt" #Capital of OAU at game start, released
SNG = "countries/Senegambia.txt" #Next capital location, 1985
#SEN = "countries/Senegal.txt" #
#GAM = "countries/Gambia.txt" #
LIB = "countries/Liberia.txt" #Second-next capital location, 1990
KRU = "countries/Doe Liberia.txt"#liberian civil war tag
IVO = "countries/Ivory Coast.txt" #Third-next, 1995
UPV = "countries/Upper Volta.txt" #Should have Sankara, "Boxer"-style rebellion in 1980s
BKF = "countries/Burkina Faso.txt" #the "Boxer"-style rebellion
BEN = "countries/Dahomey.txt"
GHA = "countries/Ghana.txt"
TOG = "countries/Togo.txt"
NGE = "countries/Niger.txt" #4th-next capital, 2000. Liberian, Guinea-Bissau, Sierra Leone revolt 
SIE = "countries/Sierra Leone.txt"
GIB = "countries/Guinea-Bissau.txt"
GUN = "countries/Guinea.txt"
TUA = "countries/Tuareg Confederation.txt"
CAS = "countries/Casamance.txt"

#Greater Mauretania, Stomping ground for OAU. sad but true
#MAU = "countries/Mauretania.txt" 
#Azawad, north Mali, etc...
AZA = "countries/Azawad.txt"
TRZ = "countries/Trarza.txt"
SAR = "countries/Sahrawi.txt"

NIG = "countries/Nigeria.txt" #at start, Oyo + some of west Sokotoland, next to Benin.
OYO = "countries/Oyo.txt"
BIA = "countries/Biafra.txt"
HAU = "countries/Hausaland.txt" #puppet under Biafra
BNN = "countries/Benin.txt"
BEU = "countries/Benue.txt"
#Tags for OAS military cliques?
ASN = "countries/Mandatory Nigeria.txt"

CAM = "countries/Cameroon.txt"
AMB = "countries/Ambazonia.txt"
CHD = "countries/Chad.txt"
GAB = "countries/Gabon.txt"
COG = "countries/Congo.txt"
EQU = "countries/Equatorial Guinea.txt"
SAT = "countries/Sao Tome and Principe.txt"

#central Africa
CAE = "countries/Empire of Central Africa.txt"
BAO = "countries/Birao.txt"
AZD = "countries/Azande.txt"
KAT = "countries/Katanga.txt"
KSI = "countries/Kasai.txt"
KWI = "countries/Kwilu.txt"
KVU = "countries/Kivu.txt"
ALU = "countries/Alur.txt"
UBA = "countries/Ubangi.txt"
ZAS = "countries/Congo-Stanleyville.txt"
ZAK = "countries/Congo-Kinshasa.txt"
ZAI = "countries/Zaire.txt"

#Eastern Africa
EAF = "countries/East African Federation.txt"
TZN = "countries/Tanzania.txt"
RWA = "countries/Rwanda.txt"
BRD = "countries/Burundi.txt"
KEN = "countries/Kenya.txt"
UGA = "countries/Uganadan.txt"
SUD = "countries/Sudan.txt"
SSD = "countries/South Sudan.txt"
DAF = "countries/Darfur.txt"

#Ethiopia
TNF = "countries/EPRDF.txt"
IHA = "countries/Ihapa.txt"
DRG = "countries/Derg.txt"
AFR = "countries/Afar.txt"
ORO = "countries/Oromo.txt"
ETH = "countries/Ethiopia.txt"
ERI = "countries/Eritrea.txt"
DJI = "countries/Djibouti.txt"
#somalia
SOM = "countries/Somalia.txt"
SML = "countries/Somaliland.txt"
WSL = "countries/West Somalia.txt"

#Southern Africa
ANG = "countries/Angola.txt"
CAB = "countries/Cabinda.txt"
NAM = "countries/Nambia.txt"
ZAM = "countries/Zambia.txt"
BOT = "countries/Botswana.txt"
MOZ = "countries/Mozambique.txt"
MLW = "countries/Malawi.txt"
MAD = "countries/Madagascar.txt"
CMO = "countries/Comoros.txt"
SEY = "countries/Seychelles.txt"
MAU = "countries/Mauritius.txt"

ZRH = "countries/Zimbabwe-Rhodesia.txt"
ZIM = "countries/Zimbabwe.txt"
#South Africa

#Middle East
#UAR possible members
UAR = "countries/United Arab Republics.txt" #the 72 proposal
EGY = "countries/Egypt.txt"
SYR = "countries/Syria.txt"
IRQ = "countries/Iraq.txt"
PAL = "countries/Palestine.txt"

ISR = "countries/Israel.txt"
LEB = "countries/Lebanon.txt"
JOR = "countries/Jordan.txt"
SAU = "countries/Saudi Arabia.txt"
UAE = "countries/UAE.txt"
QAT = "countries/Qatar.txt"
BHR = "countries/Bahrain.txt"
KUW = "countries/Kuwait.txt"
OMN = "countries/Oman.txt"
SYM = "countries/South Yemen.txt"
YEM = "countries/Yemen.txt"
DHO = "countries/Dhofar.txt"
ISS = "countries/Islamic State.txt"

#Anatolia-Caucasus
TUR = "countries/Turkey.txt"
ARM = "countries/Armenia.txt"
KRD = "countries/Kurdistan.txt"
AZB = "countries/Azerbaijan.txt"
TAL = "countries/Talysh.txt"

GEO = "countries/Georgia.txt"
ABK = "countries/Abkhazia.txt"
ADJ = "countries/Adjara.txt"
OSS = "countries/Ossetia.txt"
CHC = "countries/Chechnya.txt"
DAG = "countries/Dagestan.txt"

#Persia
EKD = "countries/East Kurdistan.txt"
KUZ = "countries/Khuzestan.txt"
IRN = "countries/Iran.txt"
SRN = "countries/Fadaiyan-e-Khalq.txt"

#Afghanistan
AFG = "countries/Afghanistan.txt"
DRA = "countries/Soviet Afghanistan.txt"
TLI = "countries/Taliban.txt"
NAA = "countries/Northern Afghanistan.txt"

# Indian Subcontinent
PAK = "countries/Pakistan.txt"
SKH = "countries/Khalistan.txt"
KSJ = "countries/Kashmir.txt"
DHI = "countries/Delhi.txt"
RAJ = "countries/Rajastan.txt"
BAN = "countries/Bengal.txt"
SIK = "countries/Sikkim.txt"
GRK = "countries/Gorkhaland.txt"
BOD = "countries/Bodo.txt"
ASS = "countries/Assam.txt"
NAG = "countries/Nagalim.txt"
MNP = "countries/Manipur.txt"
TIP = "countries/Tipura.txt"
MIZ = "countries/Mizoram.txt"
JUM = "countries/Jummaland.txt"
BHI = "countries/Bhilistan.txt"
GDW = "countries/Gondwana.txt"
HYD = "countries/Hyderabad.txt"
NAX = "countries/Naxilites.txt"#indian communist rebels, when not communist becomes Orissa 
GUJ = "countries/Gujarat.txt"
DEC = "countries/Deccan Federation.txt"
SRL = "countries/Sri Lanka.txt"
MAL = "countries/Maldives.txt"
HND = "countries/India.txt"

BHU = "countries/Bhutan.txt"
NEP = "countries/Nepal.txt"

#Indochina
BRM = "countries/Burma.txt"
MON = "countries/Mon.txt"
KRN = "countries/Karen.txt"
SHN = "countries/Shan.txt"
THI = "countries/Thailand.txt"
LAO = "countries/Laos.txt"
VIT = "countries/Vietnam.txt"
CMB = "countries/Cambodia.txt"
MLY = "countries/Malaysia.txt"
SRW = "countries/Sarawak.txt"
SGP = "countries/Singapore.txt"
PTN = "countries/Patani.txt"

#Indonesia
ACH = "countries/Aceh.txt"#
TPN = "countries/Tapanuli.txt"#
RIU = "countries/Riau.txt"#
MNK = "countries/Minangkabau.txt"#
SJY = "countries/Srivijaya.txt"#
SMT = "countries/Sumatra.txt"#formable

BRU = "countries/Brunei.txt"#
SLU = "countries/Sulu.txt"#
DAY = "countries/Dayak.txt"#

INR = "countries/Indonesian Rump State.txt"#
YOG = "countries/Yoygakarta.txt"#
BLI = "countries/Bali.txt"#
SUM = "countries/Sumba.txt"#
SBW = "countries/Sumbawa.txt"#
GTM = "countries/Greater Timor.txt"#
FLO = "countries/Flores.txt"#
SAS = "countries/Sasak.txt"#
PSD = "countries/Pasundan.txt"#

MNH = "countries/Minahasa.txt"#
SUL = "countries/South Sulawesi.txt"#
AMN = "countries/Ambona.txt"#
SLW = "countries/Sulawesi.txt"#

INO = "countries/Indonesia.txt"#final formable

#australasia
ASC = "countries/Australasian Compact.txt"
NSW = "countries/New South Wales.txt"#
QUE = "countries/Queensland.txt"#
WSA = "countries/Western Australia.txt"#
SOA = "countries/South Australia.txt"#
VIC = "countries/Victoria.txt"#
TAS = "countries/Tasmania.txt"#
AUS = "countries/Australia.txt"#
WPP = "countries/West Papua.txt"#
PNG = "countries/Papua New Guinea.txt"#
BOU = "countries/Bougainville.txt"#
NZL = "countries/New Zealand.txt"#

ILO = "countries/Ilocos.txt"#
COR = "countries/Cordillera.txt"#
MNL = "countries/Manila.txt"#
BIC = "countries/Bicolano.txt"#
VYS = "countries/Visayas.txt"#
MND = "countries/Mindanao.txt"#
ZMB = "countries/Zamboanga.txt"#
MRO = "countries/Moro.txt"#

PHL = "countries/Philippines.txt"#

#Oceania
TTP = "countries/American Pacific.txt"
NWC = "countries/New Caledonia.txt"
TVU = "countries/Tuvalu.txt"
VAN = "countries/Vanuatu.txt"
FJI = "countries/Fiji.txt"
SAM = "countries/Samoa.txt"
TNG = "countries/Tonga.txt"
NUE = "countries/Niue.txt"
TOK = "countries/Tokelau.txt"
COK = "countries/Cook Islands.txt"
TAH = "countries/Tahiti.txt"
ESI = "countries/Easter Island.txt"
WAF = "countries/Wallis and Futuna.txt"
NAU = "countries/Nauru.txt"

QQQ = "countries/DEBUG.txt"

## HoD Dominions
dynamic_tags  = yes # any tags after this is considered dynamic dominions